asdasd
pablo
19,18
asdasd
%MAPSOUND%

1:0-0:101;1:0-0:101;1:0-0:101;1:0-0:101;1:0-0:101;1:1-999:160;1:0-0:101;1:0-0:101;1:0-0:101;1:0-0:101;1:0-0:101;1:0-0:101;1:0-0:101;1:0-0:101;1:0-0:101;1:0-0:101;1:0-0:101;1:0-0:101;1:0-0:101
1:0-0:101;1:0-0:101;1:8-0-999,999,381,999,1,luis,cagaste,999,100,999,999,%NULL%,False,True,4,NORMAL,NORMAL,monstruo1:101;1:0-0:101;1:0-0:101;1:0-0:160;1:0-0:101;1:0-0:101;1:0-0:101;1:0-0:101;1:8-0-999,999,381,999,1,luis,cagaste,999,1,999,999,%NULL%,False,True,4,NORMAL,NORMAL,monstruo1:101;1:0-0:101;1:0-0:101;1:0-0:101;1:0-0:101;1:0-0:101;1:0-0:101;1:0-0:101;1:0-0:101
1:0-0:101;1:0-0:101;0:2-200:101;0:2-200:101;0:2-200:101;1:0-0:101;1:0-0:160;1:2-200:101;1:2-200:101;1:0-0:101;1:0-0:101;1:0-0:101;1:0-0:101;1:0-0:101;1:0-0:101;1:0-0:101;1:0-0:101;1:0-0:101;1:0-0:101
1:0-0:101;1:2-200:101;0:0-0:101;0:4-0:152;0:0-0:101;0:0-0:101;0:2-200:160;0:2-200:101;0:0-0:101;1:2-200:101;1:0-0:101;1:0-0:101;1:0-0:101;1:0-0:101;1:0-0:101;1:0-0:101;1:0-0:101;1:0-0:101;1:0-0:101
1:0-0:101;1:2-200:101;0:0-0:101;0:0-0:101;0:4-0:152;0:0-0:101;0:0-0:160;0:4-0:152;0:0-0:101;0:2-200:101;0:2-200:101;0:0-0:101;1:0-0:101;1:0-0:101;1:0-0:101;1:0-0:101;1:0-0:101;1:0-0:101;1:0-0:101
1:0-0:101;1:0-0:101;0:0-0:101;0:4-0:152;0:4-0:152;0:4-0:152;0:0-0:160;0:4-0:152;0:4-0:152;0:0-0:101;0:2-200:152;0:0-0:101;0:0-0:101;0:0-0:101;1:0-0:101;1:0-0:101;1:0-0:101;1:0-0:101;1:0-0:101
1:0-0:101;1:2-200:101;0:0-0:101;0:4-0:152;0:0-0:101;0:4-0:152;0:0-0:160;0:4-0:152;0:4-0:152;0:2-200:101;0:2-200:101;0:0-0:101;0:4-0:152;0:0-0:101;1:8-0-999,999,381,999,1,luis,cagaste,999,1,999,9999999,%NULL%,False,True,4,NORMAL,NORMAL,monstruo1:101;1:0-0:101;1:0-0:101;1:0-0:101;1:0-0:101
1:0-0:101;1:0-0:101;0:2-200:101;0:4-0:152;0:4-0:152;0:0-0:101;0:0-0:160;0:4-0:152;0:0-0:101;0:2-200:101;0:0-0:101;0:0-0:101;0:0-0:101;0:0-0:101;1:0-0:101;1:0-0:101;1:0-0:101;1:0-0:101;1:0-0:101
1:0-0:101;1:0-0:101;0:2-200:101;0:0-0:101;0:4-0:152;0:4-0:152;0:0-0:160;0:4-0:152;0:0-0:101;0:2-200:101;0:4-0:152;0:0-0:101;1:0-0:101;1:0-0:101;1:0-0:101;1:0-0:101;1:0-0:101;1:0-0:101;1:0-0:101
1:0-0:101;1:0-0:101;1:0-0:101;0:2-200:101;0:0-0:101;0:4-0:152;0:0-0:160;0:4-0:152;0:2-200:152;0:0-0:101;0:0-0:101;0:0-0:101;1:0-0:101;1:0-0:101;1:8-0-999,999,381,999,1,luis,cagaste,999,1,999,999,%NULL%,False,True,4,NORMAL,NORMAL,monstruo1:101;1:0-0:101;1:0-0:101;1:0-0:101;1:0-0:101
1:0-0:101;1:0-0:101;1:0-0:101;1:2-200:101;0:0-0:101;0:0-0:101;0:0-0:160;0:0-0:101;0:0-0:101;0:0-0:101;0:0-0:101;1:0-0:101;1:0-0:101;1:8-0-999,999,381,999,1,luis,cagaste,999,1,999,999,%NULL%,False,True,4,NORMAL,NORMAL,monstruo1:101;1:0-0:101;1:0-0:101;1:0-0:101;1:0-0:101;1:0-0:101
1:0-0:101;1:0-0:101;1:0-0:101;1:0-0:101;1:0-0:101;1:0-0:160;1:0-0:160;1:0-0:101;0:0-0:101;0:4-0:152;0:0-0:101;0:0-0:101;0:0-0:101;0:0-0:101;1:0-0:101;1:0-0:101;1:0-0:101;1:0-0:101;1:0-0:101
1:0-0:101;1:8-0-999,999,381,999,1,luis,cagaste,999,1,999,999,%NULL%,False,True,4,NORMAL,NORMAL,monstruo1:101;1:0-0:101;1:0-0:101;1:0-0:101;1:0-0:160;1:0-0:101;1:0-0:101;0:0-0:101;0:0-0:101;0:0-0:101;0:0-0:101;0:4-0:152;0:0-0:101;1:0-0:101;1:0-0:101;1:0-0:101;1:0-0:101;1:0-0:101
1:0-0:101;1:0-0:101;1:0-0:101;1:0-0:101;1:0-0:160;1:0-0:101;1:0-0:101;1:0-0:101;1:0-0:101;0:0-0:101;0:0-0:101;0:0-0:101;0:0-0:101;0:0-0:101;1:0-0:101;1:0-0:101;1:0-0:101;1:0-0:101;1:0-0:101
1:0-0:101;1:0-0:101;1:0-0:101;1:0-0:160;1:0-0:160;1:0-0:101;1:0-0:101;1:0-0:101;1:0-0:101;0:0-0:101;0:4-0:152;0:4-0:152;0:0-0:101;1:0-0:101;1:0-0:101;1:0-0:101;1:0-0:101;1:0-0:101;1:0-0:101
1:0-0:101;1:0-0:101;1:0-0:101;1:0-0:160;1:0-0:160;1:8-0-999,999,381,999,1,luis,cagaste,999,1,999,9999999,%NULL%,False,True,4,NORMAL,NORMAL,monstruo1:101;1:0-0:101;1:0-0:101;1:0-0:101;0:0-0:101;0:4-0:152;0:4-0:152;0:0-0:101;1:0-0:101;1:0-0:101;1:0-0:101;1:0-0:101;1:0-0:101;1:0-0:101
1:0-0:101;1:0-0:101;1:0-0:101;1:0-0:160;1:0-0:101;1:0-0:101;1:0-0:101;1:0-0:101;1:0-0:101;0:0-0:101;0:0-0:101;0:0-0:101;0:0-0:101;1:0-0:101;1:0-0:101;1:0-0:101;1:8-0-999,999,381,999,1,luis,cagaste,999,1,999,999,%NULL%,False,True,4,NORMAL,NORMAL,monstruo1:101;1:0-0:101;1:0-0:101
1:0-0:101;1:0-0:101;1:0-0:101;1:0-0:160;1:0-0:160;1:0-0:101;1:0-0:101;1:0-0:101;1:0-0:101;1:0-0:101;1:0-0:101;1:0-0:101;1:0-0:101;1:0-0:101;1:0-0:101;1:0-0:101;1:0-0:101;1:0-0:101;1:0-0:101
