testfightmob1
Pablo
19,18
Mapa diseñado para probar las peleas, ataques, persecuciones, etc
%MAPSOUND%

0:0-0:101;0:0-0:101;0:0-0:101;0:0-0:101;0:0-0:101;0:0-0:101;0:0-0:101;0:0-0:101;0:0-0:101;0:0-0:101;0:0-0:101;0:0-0:101;0:0-0:101;0:0-0:101;0:0-0:101;0:0-0:101;0:0-0:101;0:0-0:101;0:0-0:101
0:0-0:101;0:0-0:101;0:0-0:101;0:0-0:101;0:0-0:101;0:0-0:101;0:0-0:101;0:0-0:101;0:0-0:101;0:0-0:101;0:0-0:101;0:0-0:101;0:0-0:101;0:0-0:101;0:0-0:101;0:0-0:101;0:0-0:101;0:0-0:101;0:0-0:101
0:0-0:101;0:0-0:101;0:0-0:101;0:0-0:101;0:0-0:101;0:0-0:101;0:0-0:101;0:8-0-0,100,386,0,1,Mono que se mueve mucho,Mono que se mueve infinitamente,0,100,0,0,%NULL%,False,False,0:134;0:0-0:101;0:0-0:101;0:0-0:101;0:0-0:101;0:0-0:101;0:0-0:101;0:0-0:101;0:0-0:101;0:0-0:101;0:0-0:101;0:0-0:101
0:0-0:101;0:0-0:101;0:0-0:101;0:0-0:101;0:0-0:101;0:0-0:101;0:0-0:101;0:0-0:101;0:0-0:101;0:0-0:101;0:0-0:101;0:0-0:101;0:0-0:101;0:0-0:101;0:0-0:101;0:0-0:101;0:0-0:101;0:0-0:101;0:0-0:101
0:0-0:101;0:0-0:101;0:0-0:101;0:0-0:101;0:0-0:101;0:0-0:101;0:0-0:101;0:0-0:101;0:0-0:101;0:0-0:101;0:0-0:101;0:0-0:175;0:0-0:175;0:0-0:175;0:0-0:175;0:0-0:175;0:0-0:101;0:0-0:101;0:0-0:101
0:0-0:101;0:0-0:101;0:0-0:175;0:0-0:175;0:0-0:175;0:0-0:101;0:0-0:101;0:0-0:101;0:0-0:101;0:0-0:101;0:0-0:101;0:0-0:175;0:0-0:175;0:0-0:175;0:0-0:175;0:0-0:175;0:0-0:101;0:0-0:101;0:0-0:101
0:0-0:101;0:0-0:101;0:0-0:175;0:8-0-0,100,371,0,1,Enemigo mortal,Un enemigo mortal,0,100,0,0,%NULL%,False,False,1:146;0:0-0:175;0:0-0:101;0:0-0:101;0:0-0:101;0:1-999:101;0:0-0:101;0:0-0:101;0:0-0:175;0:0-0:175;0:8-0-0,100,371,0,1,Enemigo mortal,Un enemigo mortal,0,100,0,0,%NULL%,False,True,2:146;0:0-0:175;0:0-0:175;0:0-0:101;0:0-0:101;0:0-0:101
0:0-0:101;0:0-0:101;0:0-0:175;0:0-0:175;0:0-0:175;0:0-0:101;0:0-0:101;0:0-0:101;0:0-0:101;0:0-0:101;0:0-0:101;0:0-0:175;0:0-0:175;0:0-0:175;0:0-0:175;0:0-0:175;0:0-0:101;0:0-0:101;0:0-0:101
0:0-0:101;0:0-0:101;0:0-0:101;0:0-0:101;0:0-0:101;0:0-0:101;0:0-0:101;0:0-0:101;0:0-0:101;0:0-0:101;0:0-0:101;0:0-0:175;0:0-0:175;0:0-0:175;0:0-0:175;0:0-0:175;0:0-0:101;0:0-0:101;0:0-0:101
0:0-0:101;0:0-0:101;0:0-0:101;0:0-0:101;0:0-0:101;0:0-0:101;0:0-0:101;0:0-0:101;0:0-0:101;0:0-0:101;0:0-0:101;0:0-0:101;0:0-0:101;0:0-0:101;0:0-0:101;0:0-0:101;0:0-0:101;0:0-0:101;0:0-0:101
0:0-0:101;0:0-0:101;0:0-0:101;0:0-0:101;0:0-0:101;0:0-0:101;0:0-0:175;0:0-0:175;0:0-0:175;0:0-0:175;0:0-0:175;0:0-0:101;0:0-0:101;0:0-0:101;0:0-0:101;0:0-0:101;0:0-0:101;0:0-0:101;0:0-0:101
0:0-0:101;0:0-0:101;0:0-0:101;0:0-0:101;0:0-0:101;0:0-0:101;0:0-0:175;0:0-0:175;0:0-0:175;0:0-0:175;0:0-0:175;0:0-0:101;0:0-0:101;0:0-0:101;0:0-0:101;0:0-0:101;0:0-0:101;0:0-0:101;0:0-0:101
0:0-0:101;0:0-0:101;0:0-0:101;0:0-0:101;0:0-0:101;0:0-0:101;0:0-0:175;0:0-0:175;0:8-0-0,100,371,0,1,Enemigo mortal,Un enemigo mortal,0,100,0,0,%NULL%,True,False,2:146;0:0-0:175;0:0-0:175;0:0-0:101;0:0-0:101;0:0-0:101;0:0-0:101;0:0-0:101;0:0-0:101;0:0-0:101;0:0-0:101
0:0-0:101;0:0-0:101;0:0-0:101;0:0-0:101;0:0-0:101;0:0-0:101;0:0-0:175;0:0-0:175;0:0-0:175;0:0-0:175;0:0-0:175;0:0-0:101;0:0-0:101;0:0-0:101;0:0-0:101;0:0-0:101;0:0-0:101;0:0-0:101;0:0-0:101
0:0-0:101;0:0-0:101;0:0-0:101;0:0-0:101;0:0-0:101;0:0-0:101;0:0-0:175;0:0-0:175;0:0-0:175;0:0-0:175;0:0-0:175;0:0-0:101;0:0-0:101;0:0-0:101;0:0-0:101;0:0-0:101;0:0-0:101;0:0-0:101;0:0-0:101
0:0-0:101;0:0-0:101;0:0-0:101;0:0-0:101;0:0-0:101;0:0-0:101;0:0-0:101;0:0-0:101;0:0-0:101;0:0-0:101;0:0-0:101;0:0-0:101;0:0-0:101;0:0-0:101;0:0-0:101;0:0-0:101;0:0-0:101;0:0-0:101;0:0-0:101
0:0-0:101;0:0-0:101;0:0-0:101;0:0-0:101;0:0-0:101;0:0-0:101;0:0-0:101;0:0-0:101;0:0-0:101;0:0-0:101;0:0-0:101;0:0-0:101;0:0-0:101;0:0-0:101;0:0-0:101;0:0-0:101;0:0-0:101;0:0-0:101;0:0-0:101
0:0-0:101;0:0-0:101;0:0-0:101;0:0-0:101;0:0-0:101;0:0-0:101;0:0-0:101;0:0-0:101;0:0-0:101;0:0-0:101;0:0-0:101;0:0-0:101;0:0-0:101;0:0-0:101;0:0-0:101;0:0-0:101;0:0-0:101;0:0-0:101;0:0-0:101
